10 20 720 280 
1 1 1 1 1 1 1 1 1 1 1 1 1 1 1 1 1 1 1 1 
1 6 6 6 6 6 6 6 6 6 6 6 6 6 6 6 6 6 6 1 
1 0 0 0 0 0 0 0 0 0 0 0 0 0 0 0 0 0 0 1 
1 0 0 0 0 0 0 0 0 0 0 0 0 0 0 0 0 0 7 1 
1 0 0 0 0 0 0 0 0 0 0 0 0 0 0 0 0 0 0 1 
1 3 3 0 0 0 0 0 0 0 0 0 0 0 0 0 0 0 0 1 
1 3 3 3 0 0 0 0 0 0 0 0 5 0 0 0 0 0 0 1 
1 3 3 3 3 0 0 0 0 0 0 0 0 0 0 0 0 0 0 1 
1 3 3 3 3 3 0 0 0 0 0 0 0 0 0 0 0 0 0 1 
1 1 1 1 1 1 1 1 1 1 1 1 1 1 1 1 1 1 1 1 
